032000030203203000003003003000000101302330000
100020022000203020000012300000300000020022000
300000000101002001000000003133031332010100000
002022003010330000302000002000003331000000202
000203000100020030001022203000010220020200002
100000002000020000010001001012030001000100002
012103013203000100010003132002300000000001032
010000000003010110000010000200100100003301210
000020000030012000200000012000010230020000001
032000030203203000003003003000000101302330000
100020022000203020000012300000300000020022000
300000000101002001000000003133031332010100000
002022003010330000302000002000003331000000202
000203000100020030001022203000010220020200002
100000002000020000010001001012030001000100002
012103013203000100010003132002300000000001032
010000000003010110000010000200100100003301210
000020000030012000200000012000010230020000001